00000000000000
00000000000000
00000000000000
00000000000000
00000000000000
00000000000000
01111100000000
00000000000000
00000000000000
00000000001110
00000001100000
00000000000000
00000000000000
11111111111111